4444444444444444444444411111111144444444444444444444444
4400000000000000000000400000000040000000000000000000004
4044444444444404444440400000000040444444444444444444404
4040000000000000000040400000000040400000000000000000404
4040444444444444444040400000000040404444444444444440404
4040400000000000004040400000000040404000000000000040404
4040404444444444404040400000000040404044444444444040404
4040404000000000404040400000000040404040000000004040404
4000404000000000400040400000000040004040000000004040404
4440404000000000404040400000000040400040000000004040404
4040444000000000404040400000000040404040000000004040004
4040404000000000404040400000000040404040000000004444404
4040404000030000404040400000000040404040000500004000404
4040404000000000404040400000000040404040000000004040404
4000004000000000404040400000000040404040000000004040404
4040404000000000400000400000000040404000000000004040404
4040404000000000404444444444444444444440000000004040404
4040404444444404400000000004000000000044444444444040404
4040400000000404444044444444444444404000000000000040404
4040444444444400004040000004000000004044444444444440404
4040000000000404404044000000000044444040000000000000404
4044444444444444404044000000000004404044444044444444404
4000000000000000004000440444440440404040000000000000004
4444444444444444444040440000000440404044444444444444444
1000000000000000404040004440544040404040000000000000001
1000000000000000404044404000004040404040000000000000001
1000000000000000404040003000004040404040000000000000001
1000000000000000404044400000000044404440000000000000001
1000000000000000404040404000001040004040000000000000001
1000000000000000404040404000004040404040000000000000001
1000000000000000404000004420444000404040000000000000001
1000000000000000404044440000000440404040000000000000001
4444444444444444404040444044404440404044444444444444444
4000000000000000404044000004000004404040000000000000004
4044444440444444400044444044440444400044444444444444404
4040000000000400404400000000000000044000000000000000404
4440444444440440404440444444440444444044444444444440404
4040400000400000440000000004000000000440000000000040404
4040404444444440400440444444444444444444404444444040404
4040404000000040404040400000000040404040000000004040404
4040404000000040404040400000000040004040000000004040404
4040404000000000404040400000000040400040000000004040404
4440444000000000404040400000000040404040000000004040004
4000004000020000400040400000000040404040000100004044404
4040404000000000404040400000000040404040000000004000404
4040404000000000404040400000000040404040000000004040404
4040404000000000404044400000000040404040000000004040404
4040404000000000404000400000000040404040000000004040404
4044404444444444404040400000000040404044444444444040404
4040000000000040004040400000000040404000000000000040404
4040444444444444444040400000000040404444444444444440404
4000000000000000040040400000000040400000000000000000404
4044444444444444044440400000000040444444444444444444404
4000000000000004000000400000000040000000000000000000004
4444444444444444444444411111111144444444444444444444444
